111111111111111111
1P1000000111000001
101100000111000C01
100101100000010001
10000011C000010001
100000010010010001
100000010010010001
100000010010010001
100100010010110001
100100011111100001
100100011111100001
101110011111100001
100C11010000111101
100010010000100001
1000100100001E0001
100010010000001001
100011110000001101
1000000C0000000101
100000000000000101
111111111111111111