111111111111111111
1C01000000001000C1
10010111110C100011
1P0111E00000100001
100011111110000001
100000000011110001
111110000100000001
100C000000000C0001
111111111111111111