1111111111111
10010E0000001
1000011111011
1P001100000C1
1111111111111