111111111111111111
1001000000001000C1
100101111100100011
1P0111E00000100001
100001111110000001
100000000011110001
111110000100000001
100000000000000001
111111111111111111