111111111111111111
100100000000100001
1001011111001CP011
100111E00000100001
100001111110000001
100000000011110001
111110000100000001
100000000000000001
111111111111111111