11111111111111111111111111111
1PC000000000000000000000000E1
11111111111111111111111111111