1111111111111111111111111111111111111111
1C01000000001000C10000000000000000000001
10010111110C1000110000000000000000000001
1P0111E000001000000000000000000000000001
1000111111100000000111111111111111111111
1000000000111100010000000000000000000001
1111100001000000010000111111111111110001
100C000000000C00011111111111000000000111
1111111111111111110000000000000000000111
1000000000000000000000000000000000000001
1000000000000000000000000000000000000001
1000000000000C11100000000000000000000001
1000000000000000000000000000000000000001
1000000000000000000000000000000000000001
1000000011111000000000000000000000000001
1000001111111000000000000000000000000001
1000011111111000000000000000000000000001
10000000000CC000000000000000000000000001
1000000000000000000000000000000000000001
1000000000000000000000000000111111111111
1000000000000000000000000001111111111111
1000000000000000000000000000000000000CC1
1000000000000000000000000000000000000CC1
1111111111111111111111111111111111111111